name	occupation	name_wo_parenthesis
감우성	actors	감우성
강경준	actors	강경준
강기영	actors	강기영
강남길	actors	강남길
강동원	actors	강동원
강봉성	actors	강봉성
강석우	actors	강석우
강성민	actors	강성민
강성진	actors	강성진
강성필	actors	강성필
강승원	actors	강승원
강신일	actors	강신일
강은탁	actors	강은탁
강인덕	actors	강인덕
강정우	actors	강정우
강지섭	actors	강지섭
강지환	actors	강지환
강태오	actors	강태오
강하늘	actors	강하늘
고경표	actors	고경표
고세원	actors	고세원
고수	actors	고수
고우림	actors	고우림
고윤	actors	고윤
고인범	actors	고인범
고주원	actors	고주원
고창석	actors	고창석
공명	actors	공명
공유	actors	공유
공정환	actors	공정환
공형진	actors	공형진
곽도원	actors	곽도원
곽동연	actors	곽동연
곽시양	actors	곽시양
곽정욱	actors	곽정욱
곽희성	actors	곽희성
권상우	actors	권상우
권오중	actors	권오중
권율	actors	권율
권태원	actors	권태원
권해성	actors	권해성
권해효	actors	권해효
권혁수	actors	권혁수
권현상	actors	권현상
권화운	actors	권화운
기도훈	actors	기도훈
기주봉	actors	기주봉
기태영	actors	기태영
길용우	actors	길용우
길정우	actors	길정우
김갑수	actors	김갑수
김강우	actors	김강우
김강훈	actors	김강훈
김광규	actors	김광규
김권	actors	김권
김기두	actors	김기두
김기천	actors	김기천
김남길	actors	김남길
김다현	actors	김다현
김단율	actors	김단율
김대명	actors	김대명
김도윤	actors	김도윤
김도현	actors	김도현
김동완	actors	김동완
김동욱	actors	김동욱
김동희	actors	김동희
김래원	actors	김래원
김뢰하	actors	김뢰하
김명곤	actors	김명곤
김명민	actors	김명민
김명수	actors	김명수
김명수	actors	김명수
김명준	actors	김명준
김무열	actors	김무열
김민교	actors	김민교
김민상	actors	김민상
김민석	actors	김민석
김민수	actors	김민수
김민식	actors	김민식
김민재	actors	김민재
김민재	actors	김민재
김민종	actors	김민종
김민준	actors	김민준
김범	actors	김범
김법래	actors	김법래
김병기	actors	김병기
김병세	actors	김병세
김병옥	actors	김병옥
김상경	actors	김상경
김상중	actors	김상중
김상호	actors	김상호
김서하	actors	김서하
김석훈	actors	김석훈
김선웅	actors	김선웅
김선혁	actors	김선혁
김선호	actors	김선호
김성균	actors	김성균
김성민	actors	김성민
김성수	actors	김성수
김성오	actors	김성오
김성철	actors	김성철
김수로	actors	김수로
김수현	actors	김수현
김승수	actors	김승수
김승우	actors	김승우
김시후	actors	김시후
김영광	actors	김영광
김영대	actors	김영대
김영민	actors	김영민
김영재	actors	김영재
김영준	actors	김영준
김영철	actors	김영철
김영호	actors	김영호
김영훈	actors	김영훈
김예준	actors	김예준
김용건	actors	김용건
김용민	actors	김용민
김용희	actors	김용희
김우빈	actors	김우빈
김유석	actors	김유석
김윤석	actors	김윤석
김응수	actors	김응수
김이안	actors	김이안
김인권	actors	김인권
김인문	actors	김인문
김인태	actors	김인태
김일우	actors	김일우
김재영	actors	김재영
김재욱	actors	김재욱
김재원	actors	김재원
김재중	actors	김재중
김정균	actors	김정균
김정민	actors	김정민
김정욱	actors	김정욱
김정운	actors	김정운
김정태	actors	김정태
김정학	actors	김정학
김정현	actors	김정현
김정현	actors	김정현
김정훈	actors	김정훈
김종결	actors	김종결
김종구	actors	김종구
김주승	actors	김주승
김주영	actors	김주영
김주영	actors	김주영
김주혁	actors	김주혁
김준	actors	김준
김준	actors	김준
김준성	actors	김준성
김준수	actors	김준수
김준한	actors	김준한
김지석	actors	김지석
김지한	actors	김지한
김지후	actors	김지후
김지훈	actors	김지훈
김진	actors	김진
김진규	actors	김진규
김진수	actors	김진수
김진우	actors	김진우
김진엽	actors	김진엽
김진해	actors	김진해
김찬우	actors	김찬우
김창완	actors	김창완
김철기	actors	김철기
김철수	actors	김철수
김태우	actors	김태우
김태정	actors	김태정
김태형	actors	김태형
김태훈	actors	김태훈
김학규	actors	김학규
김학선	actors	김학선
김현빈	actors	김현빈
김현수	actors	김현수
김현중	actors	김현중
김형묵	actors	김형묵
김형민	actors	김형민
김형범	actors	김형범
김형일	actors	김형일
김형준	actors	김형준
김혜성	actors	김혜성
김호진	actors	김호진
김홍파	actors	김홍파
김흥기	actors	김흥기
김흥수	actors	김흥수
김희갑	actors	김희갑
김희라	actors	김희라
김희원	actors	김희원
나광훈	actors	나광훈
나성균	actors	나성균
나한일	actors	나한일
남경읍	actors	남경읍
남궁민	actors	남궁민
남궁원	actors	남궁원
남다름	actors	남다름
남성진	actors	남성진
남성훈	actors	남성훈
남우현	actors	남우현
남일우	actors	남일우
남주혁	actors	남주혁
남포동	actors	남포동
노민우	actors	노민우
노영국	actors	노영국
노영학	actors	노영학
노주현	actors	노주현
노태엽	actors	노태엽
다니엘 헤니	actors	다니엘 헤니
데니 안	actors	데니 안
데프콘	actors	데프콘
도경수	actors	도경수
도상우	actors	도상우
도지한	actors	도지한
독고성	actors	독고성
독고영재	actors	독고영재
루이찬	actors	루이찬
류담	actors	류담
류덕환	actors	류덕환
류수영	actors	류수영
류승룡	actors	류승룡
류승범	actors	류승범
류승수	actors	류승수
류정한	actors	류정한
류준열	actors	류준열
류진	actors	류진
류태준	actors	류태준
리키 김	actors	리키 김
마동석	actors	마동석
마르코	actors	마르코
맹상훈	actors	맹상훈
맹세창	actors	맹세창
명계남	actors	명계남
명로진	actors	명로진
무진성	actors	무진성
문메이슨	actors	문메이슨
문성근	actors	문성근
문오장	actors	문오장
문우진	actors	문우진
문정혁	actors	문정혁
문천식	actors	문천식
문회원	actors	문회원
민영기	actors	민영기
민욱	actors	민욱
민찬기	actors	민찬기
민호	actors	민호
바로	actors	바로
박강현	actors	박강현
박건우	actors	박건우
박건형	actors	박건형
박광정	actors	박광정
박광현	actors	박광현
박규채	actors	박규채
박근형	actors	박근형
박기웅	actors	박기웅
박남현	actors	박남현
박노식	actors	박노식
박노식	actors	박노식
박동빈	actors	박동빈
박민수	actors	박민수
박민우	actors	박민우
박병선	actors	박병선
박병호	actors	박병호
박보검	actors	박보검
박신우	actors	박신우
박상면	actors	박상면
박상민	actors	박상민
박상원	actors	박상원
박서준	actors	박서준
박성웅	actors	박성웅
박성훈	actors	박성훈
박송권	actors	박송권
박시진	actors	박시진
박시후	actors	박시후
박신양	actors	박신양
박신우	actors	박신우
박영규	actors	박영규
박영록	actors	박영록
박영지	actors	박영지
박용식	actors	박용식
박용우	actors	박용우
박용진	actors	박용진
박용하	actors	박용하
박원상	actors	박원상
박유천	actors	박유천
박유환	actors	박유환
박윤배	actors	박윤배
박윤재	actors	박윤재
박은석	actors	박은석
박인환	actors	박인환
박재정	actors	박재정
박재현	actors	박재현
박정민	actors	박정민
박정민	actors	박정민
박정철	actors	박정철
박정학	actors	박정학
박종관	actors	박종관
박주형	actors	박주형
박준규	actors	박준규
박중훈	actors	박중훈
박지빈	actors	박지빈
박지수	actors	박지수
박진성	actors	박진성
박진우	actors	박진우
박진우	actors	박진우
박찬환	actors	박찬환
박창민	actors	박창민
박철	actors	박철
박철민	actors	박철민
박철호	actors	박철호
박팔영	actors	박팔영
박해수	actors	박해수
박해일	actors	박해일
박해진	actors	박해진
박해준	actors	박해준
박혁권	actors	박혁권
박형식	actors	박형식
박형준	actors	박형준
박희순	actors	박희순
배도환	actors	배도환
배성우	actors	배성우
배영만	actors	배영만
배용준	actors	배용준
백봉기	actors	백봉기
백성현	actors	백성현
백승우	actors	백승우
백윤식	actors	백윤식
백일섭	actors	백일섭
백종원	actors	백종원
변영훈	actors	변영훈
변요한	actors	변요한
변우민	actors	변우민
변희봉	actors	변희봉
봉태규	actors	봉태규
서강준	actors	서강준
서도영	actors	서도영
서범석	actors	서범석
서범식	actors	서범식
서영주	actors	서영주
서은광	actors	서은광
서인국	actors	서인국
서인석	actors	서인석
서재경	actors	서재경
서주성	actors	서주성
서준	actors	서준
서준	actors	서준
서준영	actors	서준영
서지석	actors	서지석
서지훈	actors	서지훈
서지훈	actors	서지훈
서태화	actors	서태화
서하준	actors	서하준
서현철	actors	서현철
석광렬	actors	석광렬
선동혁	actors	선동혁
선우재덕	actors	선우재덕
설경구	actors	설경구
설정환	actors	설정환
성동일	actors	성동일
성준	actors	성준
성지루	actors	성지루
성혁	actors	성혁
성훈	actors	성훈
소지섭	actors	소지섭
순동운	actors	순동운
손병호	actors	손병호
손석구	actors	손석구
손승원	actors	손승원
손종학	actors	손종학
손우현	actors	손우현
손지창	actors	손지창
손진영	actors	손진영
손창민	actors	손창민
손창호	actors	손창호
손헌수	actors	손헌수
손현주	actors	손현주
손호균	actors	손호균
손호준	actors	손호준
송강	actors	송강
송강호	actors	송강호
송건희	actors	송건희
송기윤	actors	송기윤
송병준	actors	송병준
송민재	actors	송민재
송삼동	actors	송삼동
송새벽	actors	송새벽
송승헌	actors	송승헌
송승환	actors	송승환
송영규	actors	송영규
송영창	actors	송영창
송용태	actors	송용태
송원근	actors	송원근
송원석	actors	송원석
송일국	actors	송일국
송재림	actors	송재림
송재호	actors	송재호
송재희	actors	송재희
송종호	actors	송종호
송중기	actors	송중기
송창의	actors	송창의
승재	actors	승재
신구	actors	신구
신국	actors	신국
신동우	actors	신동우
신동욱	actors	신동욱
신명철	actors	신명철
현재	actors	현재
영화	actors	영화
신민재	actors	신민재
신범식	actors	신범식
신성록	actors	신성록
신성우	actors	신성우
신성일	actors	신성일
신승환	actors	신승환
신재하	actors	신재하
신정근	actors	신정근
신하균	actors	신하균
신헌수	actors	신헌수
신현준	actors	신현준
심양홍	actors	심양홍
심지호	actors	심지호
심형탁	actors	심형탁
심희섭	actors	심희섭
안내상	actors	안내상
안도규	actors	안도규
안병경	actors	안병경
안보현	actors	안보현
안상태	actors	안상태
안석환	actors	안석환
안성기	actors	안성기
안세하	actors	안세하
안우연	actors	안우연
안재모	actors	안재모
안재욱	actors	안재욱
안재현	actors	안재현
안재환	actors	안재환
안재홍	actors	안재홍
안효섭	actors	안효섭
양동근	actors	양동근
양세종	actors	양세종
양택조	actors	양택조
양현민	actors	양현민
엄기준	actors	엄기준
엄준식	actors	엄준식
엄태구	actors	엄태구
엄태웅	actors	엄태웅
여욱환	actors	여욱환
여진구	actors	여진구
연규진	actors	연규진
연우진	actors	연우진
연정훈	actors	연정훈
연제욱	actors	연제욱
연준석	actors	연준석
염동헌	actors	염동헌
예학영	actors	예학영
오경수	actors	오경수
오광록	actors	오광록
오달수	actors	오달수
오대규	actors	오대규
오대환	actors	오대환
오만석	actors	오만석
오민석	actors	오민석
오상훈	actors	오상훈
오승윤	actors	오승윤
오의식	actors	오의식
오재무	actors	오재무
오정세	actors	오정세
오지명	actors	오지명
오지호	actors	오지호
오창석	actors	오창석
오태경	actors	오태경
오한결	actors	오한결
오현경	actors	오현경
옥택연	actors	옥택연
옹성우	actors	옹성우
왕룡	actors	왕룡
우도환	actors	우도환
우봉식	actors	우봉식
우현	actors	우현
원기준	actors	원기준
원빈	actors	원빈
유노윤호	actors	유노윤호
유동근	actors	유동근
유민규	actors	유민규
유병준	actors	유병준
유순철	actors	유순철
유승호	actors	유승호
유아인	actors	유아인
유연석	actors	유연석
유오성	actors	유오성
유인촌	actors	유인촌
유일	actors	유일
유재명	actors	유재명
유주원	actors	유주원
유준상	actors	유준상
유준서	actors	유준서
유준후	actors	유준후
유지태	actors	유지태
유태웅	actors	유태웅
유퉁	actors	유퉁
유해진	actors	유해진
육동일	actors	육동일
육성재	actors	육성재
윤계상	actors	윤계상
윤균상	actors	윤균상
윤기원	actors	윤기원
윤다훈	actors	윤다훈
윤동환	actors	윤동환
윤두준	actors	윤두준
윤봉길	actors	윤봉길
윤문식	actors	윤문식
윤박	actors	윤박
윤상현	actors	윤상현
윤선우	actors	윤선우
윤세웅	actors	윤세웅
윤세현	actors	윤세현
윤소호	actors	윤소호
윤승원	actors	윤승원
윤시윤	actors	윤시윤
윤영준	actors	윤영준
윤용현	actors	윤용현
윤제문	actors	윤제문
윤종훈	actors	윤종훈
윤주만	actors	윤주만
윤주상	actors	윤주상
윤찬영	actors	윤찬영
윤철형	actors	윤철형
윤태영	actors	윤태영
윤현민	actors	윤현민
윤홍빈	actors	윤홍빈
윤희석	actors	윤희석
이경영	actors	이경영
이경영	actors	이경영
이계인	actors	이계인
이광기	actors	이광기
이광수	actors	이광수
이규복	actors	이규복
이규성	actors	이규성
이규한	actors	이규한
이규형	actors	이규형
이기광	actors	이기광
이기영	actors	이기영
이기우	actors	이기우
이낙훈	actors	이낙훈
이다윗	actors	이다윗
이대근	actors	이대근
이대로	actors	이대로
이대엽	actors	이대엽
이덕화	actors	이덕화
이도경	actors	이도경
이도련	actors	이도련
이도현	actors	이도현
이동건	actors	이동건
이동규	actors	이동규
이동욱	actors	이동욱
이동준	actors	이동준
이동휘	actors	이동휘
이로운	actors	이로운
이문식	actors	이문식
이민기	actors	이민기
이민우	actors	이민우
이민호	actors	이민호
이범수	actors	이범수
이병욱	actors	이병욱
이병준	actors	이병준
이병헌	actors	이병헌
이상엽	actors	이상엽
이상우	actors	이상우
이상윤	actors	이상윤
이상인	actors	이상인
이서원	actors	이서원
이서진	actors	이서진
이석준	actors	이석준
이선균	actors	이선균
이성민	actors	이성민
이성열	actors	이성열
이성재	actors	이성재
이세진	actors	이세진
이세창	actors	이세창
이수완	actors	이수완
이수혁	actors	이수혁
이순재	actors	이순재
이승기	actors	이승기
이승원	actors	이승원
이승준	actors	이승준
이승현	actors	이승현
이승형	actors	이승형
이시언	actors	이시언
이영범	actors	이영범
이영후	actors	이영후
이영훈	actors	이영훈
이예춘	actors	이예춘
이완	actors	이완
이용주	actors	이용주
이윤상	actors	이윤상
이원근	actors	이원근
이원종	actors	이원종
이원종	actors	이원종
이유진	actors	이유진
이은형	actors	이은형
이이경	actors	이이경
이인성	actors	이인성
이일민	actors	이일민
이일재	actors	이일재
이장우	actors	이장우
이재균	actors	이재균
이재룡	actors	이재룡
이재백	actors	이재백
이재용	actors	이재용
이재원	actors	이재원
이재윤	actors	이재윤
이재준	actors	이재준
이재포	actors	이재포
이재황	actors	이재황
이정길	actors	이정길
이정길	actors	이정길
이정섭	actors	이정섭
이정신	actors	이정신
이정용	actors	이정용
이정재	actors	이정재
이정진	actors	이정진
이정헌	actors	이정헌
이정현	actors	이정현
이제훈	actors	이제훈
이종구	actors	이종구
이종석	actors	이종석
이종수	actors	이종수
이종원	actors	이종원
이종혁	actors	이종혁
이종현	actors	이종현
이주승	actors	이주승
이주원	actors	이주원
이주현	actors	이주현
이준	actors	이준
이준기	actors	이준기
이준영	actors	이준영
이준혁	actors	이준혁
이준혁	actors	이준혁
이지훈	actors	이지훈
이지훈	actors	이지훈
이지훈	actors	이지훈
이진수	actors	이진수
이진우	actors	이진우
이진욱	actors	이진욱
이찬	actors	이찬
이창용	actors	이창용
이창환	actors	이창환
이창훈	actors	이창훈
이천희	actors	이천희
이철민	actors	이철민
이충주	actors	이충주
이태곤	actors	이태곤
이태리	actors	이태리
이태성	actors	이태성
이태선	actors	이태선
이태환	actors	이태환
이필모	actors	이필모
이학주	actors	이학주
이한위	actors	이한위
이해우	actors	이해우
이혁재	actors	이혁재
이현우	actors	이현우
이현진	actors	이현진
이형철	actors	이형철
이호원	actors	이호원
이호재	actors	이호재
이효정	actors	이효정
이훈	actors	이훈
이희도	actors	이희도
이희준	actors	이희준
인교진	actors	인교진
임강성	actors	임강성
임대호	actors	임대호
임동진	actors	임동진
임성민	actors	임성민
임슬옹	actors	임슬옹
임시완	actors	임시완
임영규	actors	임영규
임원희	actors	임원희
임주환	actors	임주환
임지규	actors	임지규
임창정	actors	임창정
임채무	actors	임채무
임하룡	actors	임하룡
임혁	actors	임혁
임현식	actors	임현식
임형준	actors	임형준
임호	actors	임호
장광	actors	장광
장근석	actors	장근석
장기범	actors	장기범
장기용	actors	장기용
장동건	actors	장동건
장동윤	actors	장동윤
장률	actors	장률
장성원	actors	장성원
장세진	actors	장세진
장승조	actors	장승조
장용	actors	장용
장원영	actors	장원영
장태성	actors	장태성
장항선	actors	장항선
장혁	actors	장혁
장현성	actors	장현성
재희	actors	재희
전국환	actors	전국환
전노민	actors	전노민
전무송	actors	전무송
전배수	actors	전배수
전성우	actors	전성우
전운	actors	전운
전인택	actors	전인택
전지환	actors	전지환
전진기	actors	전진기
전진서	actors	전진서
전태수	actors	전태수
정겨운	actors	정겨운
정경호	actors	정경호
정경호	actors	정경호
정기섭	actors	정기섭
정동남	actors	정동남
정동화	actors	정동화
정동환	actors	정동환
정링컨	actors	정링컨
정만식	actors	정만식
정명준	actors	정명준
정명환	actors	정명환
정민성	actors	정민성
정보석	actors	정보석
정상훈	actors	정상훈
정석용	actors	정석용
정석원	actors	정석원
정성모	actors	정성모
정성영	actors	정성영
정승호	actors	정승호
정용화	actors	정용화
정우	actors	정우
정우성	actors	정우성
정우식	actors	정우식
정우혁	actors	정우혁
정정길	actors	정정길
정욱	actors	정욱
정욱진	actors	정욱진
정운택	actors	정운택
정원중	actors	정원중
정웅인	actors	정웅인
정은찬	actors	정은찬
정은우	actors	정은우
정은표	actors	정은표
정인기	actors	정인기
정일우	actors	정일우
정재영	actors	정재영
정재용	actors	정재용
정준하	actors	정준하
정준호	actors	정준호
정지훈	actors	정지훈
정지훈	actors	정지훈
정진	actors	정진
정진영	actors	정진영
정진운	actors	정진운
정진화	actors	정진화
정찬	actors	정찬
정태우	actors	정태우
정택현	actors	정택현
정한용	actors	정한용
정해인	actors	정해인
정현준	actors	정현준
정호근	actors	정호근
정호빈	actors	정호빈
조경환	actors	조경환
조권	actors	조권
조달환	actors	조달환
조덕현	actors	조덕현
조동혁	actors	조동혁
조민기	actors	조민기
조복래	actors	조복래
조병규	actors	조병규
조상구	actors	조상구
조상기	actors	조상기
조성하	actors	조성하
조승우	actors	조승우
조윤우	actors	조윤우
조연우	actors	조연우
조인성	actors	조인성
조재윤	actors	조재윤
조재현	actors	조재현
조정석	actors	조정석
조진웅	actors	조진웅
조춘	actors	조춘
조한선	actors	조한선
조한준	actors	조한준
조현재	actors	조현재
조형기	actors	조형기
조희봉	actors	조희봉
주민준	actors	주민준
주원	actors	주원
주지훈	actors	주지훈
주진모	actors	주진모
주진모	actors	주진모
주현	actors	주현
주호성	actors	주호성
준호	actors	준호
지윤호	actors	지윤호
지일주	actors	지일주
지성	actors	지성
지수	actors	지수
지진희	actors	지진희
지창욱	actors	지창욱
지현우	actors	지현우
진영	actors	진영
진태현	actors	진태현
차광수	actors	차광수
차도진	actors	차도진
차승원	actors	차승원
차인표	actors	차인표
차태현	actors	차태현
채상우	actors	채상우
천호진	actors	천호진
최강창민	actors	최강창민
최권수	actors	최권수
최규환	actors	최규환
최다니엘	actors	최다니엘
최대철	actors	최대철
최덕문	actors	최덕문
최동균	actors	최동균
최동준	actors	최동준
최로운	actors	최로운
최무룡	actors	최무룡
최무성	actors	최무성
최민	actors	최민
최민	actors	최민
최민수	actors	최민수
최민식	actors	최민식
최민용	actors	최민용
최병학	actors	최병학
최불암	actors	최불암
최상훈	actors	최상훈
최성국	actors	최성국
최성원	actors	최성원
최성재	actors	최성재
최성준	actors	최성준
최수종	actors	최수종
최승훈	actors	최승훈
최시원	actors	최시원
최오식	actors	최오식
최우식	actors	최우식
최우성	actors	최우성
최운교	actors	최운교
최원영	actors	최원영
최원홍	actors	최원홍
최은석	actors	최은석
최일화	actors	최일화
최재섭	actors	최재섭
최재성	actors	최재성
최재원	actors	최재원
최재호	actors	최재호
최재환	actors	최재환
최정우	actors	최정우
최정원	actors	최정원
최종원	actors	최종원
최종윤	actors	최종윤
최종환	actors	최종환
최주봉	actors	최주봉
최준용	actors	최준용
최지호	actors	최지호
최진영	actors	최진영
최진혁	actors	최진혁
최창민	actors	최창민
최철호	actors	최철호
최태준	actors	최태준
최필립	actors	최필립
최한	actors	최한
최현호	actors	최현호
탁트인	actors	탁트인
태인호	actors	태인호
태항호	actors	태항호
트위스트 김	actors	트위스트 김
판유걸	actors	판유걸
하명중	actors	하명중
하석진	actors	하석진
하정우	actors	하정우
한갑수	actors	한갑수
한상진	actors	한상진
한석규	actors	한석규
한영수	actors	한영수
한인수	actors	한인수
한재석	actors	한재석
한재석	actors	한재석
한주완	actors	한주완
한준우	actors	한준우
한지상	actors	한지상
한진희	actors	한진희
한춘일	actors	한춘일
한태일	actors	한태일
허영생	actors	허영생
허장강	actors	허장강
허정민	actors	허정민
허준호	actors	허준호
현빈	actors	현빈
현석	actors	현석
현우	actors	현우
현우성	actors	현우성
홍경인	actors	홍경인
홍광호	actors	홍광호
홍기훈	actors	홍기훈
홍동영	actors	홍동영
홍석천	actors	홍석천
홍성민	actors	홍성민
홍성우	actors	홍성우
홍성헌	actors	홍성헌
홍순창	actors	홍순창
홍요섭	actors	홍요섭
홍종현	actors	홍종현
홍태의	actors	홍태의
홍학표	actors	홍학표
황동주	actors	황동주
황범식	actors	황범식
황성웅	actors	황성웅
황인성	actors	황인성
황정리	actors	황정리
황정민	actors	황정민
황찬성	actors	황찬성
황해	actors	황해
갈소원	actors	갈소원
강경헌	actors	강경헌
강다현	actors	강다현
강두리	actors	강두리
강리나	actors	강리나
강문영	actors	강문영
강민경	actors	강민경
강민아	actors	강민아
강별	actors	강별
강부자	actors	강부자
강성아	actors	강성아
강성연	actors	강성연
강소라	actors	강소라
강소연	actors	강소연
강수연	actors	강수연
강수진	actors	강수진
강예빈	actors	강예빈
강예솔	actors	강예솔
강예원	actors	강예원
강은비	actors	강은비
강지영	actors	강지영
강한나	actors	강한나
강혜정	actors	강혜정
견미리	actors	견미리
경수진	actors	경수진
경인선	actors	경인선
고나은	actors	고나은
고두심	actors	고두심
고보결	actors	고보결
고성희	actors	고성희
고소영	actors	고소영
고아라	actors	고아라
고아성	actors	고아성
고원희	actors	고원희
고은미	actors	고은미
고은아	actors	고은아
고은아	actors	고은아
고준희	actors	고준희
고현정	actors	고현정
공승연	actors	공승연
공효진	actors	공효진
곽지민	actors	곽지민
곽진영	actors	곽진영
구재이	actors	구재이
구혜선	actors	구혜선
권다현	actors	권다현
권소현	actors	권소현
권유리	actors	권유리
권은수	actors	권은수
금단비	actors	금단비
금보라	actors	금보라
금새록	actors	금새록
기은세	actors	기은세
길해연	actors	길해연
김가란	actors	김가란
김가연	actors	김가연
김가은	actors	김가은
김가은	actors	김가은
김가희	actors	김가희
김고은	actors	김고은
김규리	actors	김규리
김규리	actors	김규리
김규리	actors	김규리
김꽃비	actors	김꽃비
김나운	actors	김나운
김남주	actors	김남주
김남주	actors	김남주
김다미	actors	김다미
김다솜	actors	김다솜
김단우	actors	김단우
김도연	actors	김도연
김동주	actors	김동주
김미경	actors	김미경
김민	actors	김민
김민경	actors	김민경
김민서	actors	김민서
김민정	actors	김민정
김민정	actors	김민정
김민주	actors	김민주
김민희	actors	김민희
김민희	actors	김민희
김민희	actors	김민희
김보경	actors	김보경
김보경	actors	김보경
김보라	actors	김보라
김보미(1958)	actors	김보미
김보미	actors	김보미
김보미	actors	김보미
김보민	actors	김보민
김보연	actors	김보연
김부선	actors	김부선
김빈	actors	김빈
김빈우	actors	김빈우
김빛나리	actors	김빛나리
김사랑	actors	김사랑
김새론	actors	김새론
김새벽	actors	김새벽
김서라	actors	김서라
김서형	actors	김서형
김선아	actors	김선아
김선아	actors	김선아
김선영	actors	김선영
김선화	actors	김선화
김설	actors	김설
김성령	actors	김성령
김성은	actors	김성은
김성은	actors	김성은
김소라	actors	김소라
김소연	actors	김소연
김소영	actors	김소영
김소원	actors	김소원
김소은	actors	김소은
김소현	actors	김소현
김소현	actors	김소현
김소혜	actors	김소혜
김수미	actors	김수미
김수안	actors	김수안
김수인	actors	김수인
김수연	actors	김수연
김수정	actors	김수정
김수정	actors	김수정
김수진	actors	김수진
김수진	actors	김수진
김수현	actors	김수현
김슬기	actors	김슬기
김시아	actors	김시아
김아중	actors	김아중
김애경	actors	김애경
김여진	actors	김여진
김영란	actors	김영란
김영애	actors	김영애
김영옥	actors	김영옥
김예령	actors	김예령
김예원	actors	김예원
김옥빈	actors	김옥빈
김용림	actors	김용림
김용선	actors	김용선
김용지	actors	김용지
김원희	actors	김원희
김유리	actors	김유리
김유리	actors	김유리
김유리	actors	김유리
김유빈	actors	김유빈
김유정	actors	김유정
김윤경	actors	김윤경
김윤경	actors	김윤경
김윤서	actors	김윤서
김윤지	actors	김윤지
김윤진	actors	김윤진
김을동	actors	김을동
김을분	actors	김을분
김이경	actors	김이경
김이지	actors	김이지
김자옥	actors	김자옥
김재화	actors	김재화
김정난	actors	김정난
김정은	actors	김정은
김정화	actors	김정화
김주령	actors	김주령
김주영	actors	김주영
김지미	actors	김지미
김지민	actors	김지민
김지성	actors	김지성
김지수	actors	김지수
김지영	actors	김지영
김지영	actors	김지영
김지영	actors	김지영
김지우	actors	김지우
김지원	actors	김지원
김지은	actors	김지은
김지현	actors	김지현
김지호	actors	김지호
김진아	actors	김진아
김진이	actors	김진이
김창숙	actors	김창숙
김청	actors	김청
김태리	actors	김태리
김태연	actors	김태연
김태희	actors	김태희
김하경	actors	김하경
김하늘	actors	김하늘
김하영	actors	김하영
김향기	actors	김향기
김해숙	actors	김해숙
김해인	actors	김해인
김현수	actors	김현수
김현숙	actors	김현숙
김현주	actors	김현주
김형자	actors	김형자
김혜리	actors	김혜리
김혜수	actors	김혜수
김혜옥	actors	김혜옥
김혜윤	actors	김혜윤
김혜은	actors	김혜은
김혜자	actors	김혜자
김혜진	actors	김혜진
김환희	actors	김환희
김효선	actors	김효선
김효진	actors	김효진
김희선	actors	김희선
김희애	actors	김희애
김희정	actors	김희정
김희정	actors	김희정
나문희	actors	나문희
나영희	actors	나영희
나해령	actors	나해령
나혜미	actors	나혜미
남규리	actors	남규리
남능미	actors	남능미
남보라	actors	남보라
남상미	actors	남상미
남정임	actors	남정임
남지현	actors	남지현
노수산나	actors	노수산나
노정의	actors	노정의
노현희	actors	노현희
노희지	actors	노희지
도은비	actors	도은비
도지원	actors	도지원
라미란	actors	라미란
랑연	actors	랑연
류아벨	actors	류아벨
류원	actors	류원
류한비	actors	류한비
류현경	actors	류현경
류혜영	actors	류혜영
류화영	actors	류화영
류효영	actors	류효영
명세빈	actors	명세빈
문가영	actors	문가영
문근영	actors	문근영
문보령	actors	문보령
문수빈	actors	문수빈
문숙	actors	문숙
문예원	actors	문예원
문정숙	actors	문정숙
문정희	actors	문정희
문지인	actors	문지인
문채원	actors	문채원
문희경	actors	문희경
민도희	actors	민도희
민영원	actors	민영원
민지아	actors	민지아
민지영	actors	민지영
민효린	actors	민효린
박규영	actors	박규영
박길라	actors	박길라
박명신	actors	박명신
박민영	actors	박민영
박민지	actors	박민지
박민하	actors	박민하
박민하	actors	박민하
박보영	actors	박보영
박상아	actors	박상아
박서영	actors	박서영
박선아	actors	박선아
박선영	actors	박선영
박선영	actors	박선영
박세영	actors	박세영
박세완	actors	박세완
박세진	actors	박세진
박소담	actors	박소담
박소은	actors	박소은
박소현	actors	박소현
박솔미	actors	박솔미
박수영	actors	박수영
박수진	actors	박수진
박순천	actors	박순천
박시연	actors	박시연
박시은	actors	박시은
박시은	actors	박시은
박신아	actors	박신아
박신혜	actors	박신혜
박아인	actors	박아인
박연수	actors	박연수
박연수	actors	박연수
박예진	actors	박예진
박원숙	actors	박원숙
박유나	actors	박유나
박은빈	actors	박은빈
박은혜	actors	박은혜
박정수	actors	박정수
박정아	actors	박정아
박정원	actors	박정원
박정자	actors	박정자
박정화	actors	박정화
박주미	actors	박주미
박주현	actors	박주현
박준금	actors	박준금
박지수	actors	박지수
박지연	actors	박지연
박지영	actors	박지영
박지예	actors	박지예
박지윤	actors	박지윤
박지현	actors	박지현
박진주	actors	박진주
박진희	actors	박진희
박초롱	actors	박초롱
박탐희	actors	박탐희
박하나	actors	박하나
박하선	actors	박하선
박한별	actors	박한별
박한솔	actors	박한솔
박해미	actors	박해미
박현숙	actors	박현숙
박혜수	actors	박혜수
박혜진	actors	박혜진
박효주	actors	박효주
박희본	actors	박희본
박희진	actors	박희진
반소영	actors	반소영
반효정	actors	반효정
방민아	actors	방민아
방은희	actors	방은희
배그린	actors	배그린
배누리	actors	배누리
배다빈	actors	배다빈
배두나	actors	배두나
배선희	actors	배선희
배수지	actors	배수지
배슬기	actors	배슬기
배윤경	actors	배윤경
배정화	actors	배정화
배종옥	actors	배종옥
배주현	actors	배주현
백승희	actors	백승희
백옥담	actors	백옥담
백지원	actors	백지원
백진희	actors	백진희
변정수	actors	변정수
사미자	actors	사미자
서갑숙	actors	서갑숙
서경화	actors	서경화
서권순	actors	서권순
서미경	actors	서미경
서미지	actors	서미지
서민정	actors	서민정
서민지	actors	서민지
서신애	actors	서신애
서영	actors	서영
서영화	actors	서영화
서영희	actors	서영희
서예지	actors	서예지
서예화	actors	서예화
서우	actors	서우
서우림	actors	서우림
서유리	actors	서유리
서유정	actors	서유정
서원	actors	서원
서은수	actors	서은수
서은우	actors	서은우
서이수	actors	서이수
서이숙	actors	서이숙
서이안	actors	서이안
서정연	actors	서정연
서주현	actors	서주현
서지영	actors	서지영
서지혜	actors	서지혜
서하	actors	서하
서현진	actors	서현진
서효림	actors	서효림
선우선	actors	선우선
선우용여	actors	선우용여
선우은숙	actors	선우은숙
설리	actors	설리
설수진	actors	설수진
설수현	actors	설수현
설인아	actors	설인아
성유리	actors	성유리
성은	actors	성은
성현아	actors	성현아
소유진	actors	소유진
소이	actors	소이
소이현	actors	소이현
손나은	actors	손나은
손담비	actors	손담비
손성윤	actors	손성윤
손숙	actors	손숙
손여은	actors	손여은
손예진	actors	손예진
손유경	actors	손유경
손은서	actors	손은서
손지현	actors	손지현
손태영	actors	손태영
송다은	actors	송다은
송선미	actors	송선미
송옥숙	actors	송옥숙
송윤아	actors	송윤아
송지우	actors	송지우
송지효	actors	송지효
송채환	actors	송채환
송하윤	actors	송하윤
송혜교	actors	송혜교
수애	actors	수애
신다은	actors	신다은
신도현	actors	신도현
신동미	actors	신동미
신민아	actors	신민아
신세경	actors	신세경
신소미	actors	신소미
신소율	actors	신소율
신신애	actors	신신애
신애	actors	신애
신애라	actors	신애라
신은경	actors	신은경
신은수	actors	신은수
신은정	actors	신은정
신이	actors	신이
신현빈	actors	신현빈
신혜선	actors	신혜선
심은경	actors	심은경
심은우	actors	심은우
심은진	actors	심은진
심은하	actors	심은하
심이영	actors	심이영
심혜진	actors	심혜진
아이유	actors	아이유
안문숙	actors	안문숙
안선영	actors	안선영
안소영	actors	안소영
안소희	actors	안소희
안은진	actors	안은진
안혜경	actors	안혜경
양미경	actors	양미경
양정아	actors	양정아
양진성	actors	양진성
양희경	actors	양희경
엄앵란	actors	엄앵란
엄유신	actors	엄유신
엄정화	actors	엄정화
엄지원	actors	엄지원
엄현경	actors	엄현경
여민정	actors	여민정
여운계	actors	여운계
연민지	actors	연민지
염정아	actors	염정아
예수정	actors	예수정
예지원	actors	예지원
오나라	actors	오나라
오미연	actors	오미연
오세정	actors	오세정
오수미	actors	오수미
오승은	actors	오승은
오승현	actors	오승현
오아연	actors	오아연
오연서	actors	오연서
오연수	actors	오연수
오연아	actors	오연아
오영실	actors	오영실
오윤아	actors	오윤아
오인혜	actors	오인혜
오지은	actors	오지은
오초희	actors	오초희
오하늬	actors	오하늬
오하영	actors	오하영
오현경	actors	오현경
옥고운	actors	옥고운
옥소리	actors	옥소리
옥자연	actors	옥자연
옥주현	actors	옥주현
왕빛나	actors	왕빛나
왕희지	actors	왕희지
원미경	actors	원미경
원진아	actors	원진아
유다인	actors	유다인
유서진	actors	유서진
유선	actors	유선
유세례	actors	유세례
유연미	actors	유연미
유인나	actors	유인나
유인영	actors	유인영
유지인	actors	유지인
유진	actors	유진
유하나	actors	유하나
유혜리	actors	유혜리
유혜정	actors	유혜정
유호린	actors	유호린
유호정	actors	유호정
윤다경	actors	윤다경
윤미라	actors	윤미라
윤보라	actors	윤보라
윤보미	actors	윤보미
윤소이	actors	윤소이
윤소희	actors	윤소희
윤손하	actors	윤손하
윤수	actors	윤수
윤슬	actors	윤슬
윤승아	actors	윤승아
윤아름	actors	윤아름
윤아정	actors	윤아정
윤여정	actors	윤여정
윤은혜	actors	윤은혜
윤예주	actors	윤예주
윤유선	actors	윤유선
윤정희	actors	윤정희
윤주희	actors	윤주희
윤지민	actors	윤지민
윤지원	actors	윤지원
윤지혜	actors	윤지혜
윤진서	actors	윤진서
윤하	actors	윤하
이경심	actors	이경심
이고은	actors	이고은
이규정	actors	이규정
이나영	actors	이나영
이나윤	actors	이나윤
이다인	actors	이다인
이다해	actors	이다해
이다희	actors	이다희
이도은	actors	이도은
이미숙	actors	이미숙
이미연	actors	이미연
이미영	actors	이미영
이민영	actors	이민영
이민정	actors	이민정
이민지	actors	이민지
이보영	actors	이보영
이보희	actors	이보희
이상숙	actors	이상숙
이상아	actors	이상아
이상희	actors	이상희
이선빈	actors	이선빈
이설	actors	이설
이성경	actors	이성경
이세영	actors	이세영
이세은	actors	이세은
이소연	actors	이소연
이솜	actors	이솜
이수경	actors	이수경
이수경	actors	이수경
이수나	actors	이수나
이수민	actors	이수민
이수민	actors	이수민
이수빈	actors	이수빈
이숙	actors	이숙
이슬아	actors	이슬아
이승연	actors	이승연
이시아	actors	이시아
이시영	actors	이시영
이시원	actors	이시원
이신애	actors	이신애
이아이	actors	이아이
이아현	actors	이아현
이엘	actors	이엘
이엘리야	actors	이엘리야
이연두	actors	이연두
이연수	actors	이연수
이연희	actors	이연희
이열음	actors	이열음
이영아	actors	이영아
이영애	actors	이영애
이영옥	actors	이영옥
이영유	actors	이영유
이영은	actors	이영은
이영은	actors	이영은
이영진	actors	이영진
이예림	actors	이예림
이경규	actors	이경규
이예원	actors	이예원
이요원	actors	이요원
이유리	actors	이유리
이유미	actors	이유미
이유비	actors	이유비
이유선	actors	이유선
이유영	actors	이유영
이유진	actors	이유진
이윤미	actors	이윤미
이윤성	actors	이윤성
이윤지	actors	이윤지
이은성	actors	이은성
이은정	actors	이은정
이은주	actors	이은주
이응경	actors	이응경
이의정	actors	이의정
이인혜	actors	이인혜
이일화	actors	이일화
이자인	actors	이자인
이재은	actors	이재은
이정은	actors	이정은
이정은	actors	이정은
이정현	actors	이정현
이주빈	actors	이주빈
이주실	actors	이주실
이주연	actors	이주연
이주영	actors	이주영
이주희	actors	이주희
이지	actors	이지
이지아	actors	이지아
이지영	actors	이지영
이지은(1971)	actors	이지은
이지은(1999)	actors	이지은
이지현	actors	이지현
이지현	actors	이지현
이지현	actors	이지현
이진	actors	이진
이진아	actors	이진아
이채영	actors	이채영
이채은	actors	이채은
이청아	actors	이청아
이초희	actors	이초희
이태란	actors	이태란
이태임	actors	이태임
이하나	actors	이하나
이하늬	actors	이하늬
이한나	actors	이한나
이항나	actors	이항나
이현경	actors	이현경
이현주	actors	이현주
이혜리	actors	이혜리
이혜미	actors	이혜미
이혜숙	actors	이혜숙
이혜영	actors	이혜영
이혜영	actors	이혜영
이효정	actors	이효정
이휘향	actors	이휘향
이희진	actors	이희진
인아	actors	인아
임성민	actors	임성민
임성언	actors	임성언
임세미	actors	임세미
임수정	actors	임수정
임수향	actors	임수향
임예진	actors	임예진
임유진	actors	임유진
임윤아	actors	임윤아
임은경	actors	임은경
임정은	actors	임정은
임주은	actors	임주은
임지연	actors	임지연
임지은	actors	임지은
임진아	actors	임진아
임화영	actors	임화영
장나라	actors	장나라
장미인애	actors	장미인애
장미희	actors	장미희
장서희	actors	장서희
장소연	actors	장소연
장소정	actors	장소정
장신영	actors	장신영
장영남	actors	장영남
장영란	actors	장영란
장윤정	actors	장윤정
장정희	actors	장정희
장진영	actors	장진영
장해금	actors	장해금
장희령	actors	장희령
장희진	actors	장희진
전계현	actors	전계현
전도연	actors	전도연
전미선	actors	전미선
전소민	actors	전소민
전수경	actors	전수경
전양자	actors	전양자
전여빈	actors	전여빈
전원주	actors	전원주
전익령	actors	전익령
전인화	actors	전인화
전종서	actors	전종서
전지현	actors	전지현
전혜빈	actors	전혜빈
전혜원	actors	전혜원
전혜진	actors	전혜진
전혜진	actors	전혜진
전혜진	actors	전혜진
전효성	actors	전효성
정가은	actors	정가은
정다빈	actors	정다빈
정다빈	actors	정다빈
정다혜	actors	정다혜
정려원	actors	정려원
정민아	actors	정민아
정선경	actors	정선경
정소민	actors	정소민
정소영	actors	정소영
정수영	actors	정수영
정수정	actors	정수정
정시아	actors	정시아
정애란	actors	정애란
정애리	actors	정애리
정연주	actors	정연주
정영숙	actors	정영숙
정예진	actors	정예진
정유미	actors	정유미
정유미	actors	정유미
정유민	actors	정유민
정유진	actors	정유진
정윤희	actors	정윤희
정은지	actors	정은지
정은채	actors	정은채
정인선	actors	정인선
정주연	actors	정주연
정채연	actors	정채연
정혜선	actors	정혜선
정혜성	actors	정혜성
정혜영	actors	정혜영
정혜원	actors	정혜원
정혜인	actors	정혜인
조련	actors	조련
조문정	actors	조문정
조미령	actors	조미령
조민수	actors	조민수
조민아	actors	조민아
조보아	actors	조보아
조수민	actors	조수민
조수향	actors	조수향
조승희	actors	조승희
조안	actors	조안
조여정	actors	조여정
조용원	actors	조용원
조우리	actors	조우리
조유정	actors	조유정
조윤희	actors	조윤희
조은숙	actors	조은숙
조이현	actors	조이현
조혜정	actors	조혜정
조혜주	actors	조혜주
주다영	actors	주다영
주민경	actors	주민경
주서은	actors	주서은
지수원	actors	지수원
지우	actors	지우
지유	actors	지유
지율	actors	지율
지이수	actors	지이수
진경	actors	진경
진기주	actors	진기주
진서연	actors	진서연
진세연	actors	진세연
진예솔	actors	진예솔
진지희	actors	진지희
진희경	actors	진희경
차수연	actors	차수연
차예련	actors	차예련
차주영	actors	차주영
차청화	actors	차청화
차화연	actors	차화연
채림	actors	채림
채민서	actors	채민서
채수빈	actors	채수빈
채시라	actors	채시라
채영인	actors	채영인
채원빈	actors	채원빈
채정안	actors	채정안
채지안	actors	채지안
천민희	actors	천민희
천우희	actors	천우희
천이슬	actors	천이슬
최강희	actors	최강희
최리	actors	최리
최명길	actors	최명길
최명빈	actors	최명빈
최송현	actors	최송현
최수영	actors	최수영
최수지	actors	최수지
최아란	actors	최아란
최여진	actors	최여진
최영완	actors	최영완
최완정	actors	최완정
최유라	actors	최유라
최유화	actors	최유화
최윤소	actors	최윤소
최윤영	actors	최윤영
최윤영	actors	최윤영
최은주	actors	최은주
최은희	actors	최은희
최자혜	actors	최자혜
최정원	actors	최정원
최정원(1981년 4월)	actors	최정원
최정윤	actors	최정윤
최지나	actors	최지나
최지연	actors	최지연
최지연	actors	최지연
최지우	actors	최지우
최진실	actors	최진실
최화정	actors	최화정
최희서	actors	최희서
추소영	actors	추소영
추수현	actors	추수현
추예진	actors	추예진
추자현	actors	추자현
태미	actors	태미
태현실	actors	태현실
표예진	actors	표예진
하나경	actors	하나경
하승리	actors	하승리
하시은	actors	하시은
하연수	actors	하연수
하연주	actors	하연주
하유미	actors	하유미
하윤경	actors	하윤경
하재숙	actors	하재숙
하지원	actors	하지원
하지은	actors	하지은
하희라	actors	하희라
한가림	actors	한가림
한가인	actors	한가인
한고은	actors	한고은
한그루	actors	한그루
한다솔	actors	한다솔
한보람	actors	한보람
한보름	actors	한보름
한보배	actors	한보배
한서진	actors	한서진
한서진	actors	한서진
한선화	actors	한선화
한소은	actors	한소은
한소희	actors	한소희
한수연	actors	한수연
한순례	actors	한순례
한아련	actors	한아련
한예리	actors	한예리
한예슬	actors	한예슬
한유이	actors	한유이
한지민	actors	한지민
한지선	actors	한지선
한지성	actors	한지성
한지안	actors	한지안
한지완	actors	한지완
한지우	actors	한지우
한지은	actors	한지은
한지혜	actors	한지혜
한채아	actors	한채아
한채영	actors	한채영
한혜린	actors	한혜린
한혜숙	actors	한혜숙
한혜진	actors	한혜진
가수	actors	가수
배우	actors	배우
한혜진	actors	한혜진
한효주	actors	한효주
함은정	actors	함은정
허영란	actors	허영란
허이재	actors	허이재
허정은	actors	허정은
현승민	actors	현승민
현영	actors	현영
홍리나	actors	홍리나
홍세미	actors	홍세미
홍수아	actors	홍수아
홍수현	actors	홍수현
홍승희	actors	홍승희
홍아름	actors	홍아름
홍은희	actors	홍은희
홍지민	actors	홍지민
홍지윤	actors	홍지윤
홍진희	actors	홍진희
효민	actors	효민
황보라	actors	황보라
황석정	actors	황석정
황선희	actors	황선희
황수정	actors	황수정
황승언	actors	황승언
황신혜	actors	황신혜
황영희	actors	황영희
황우슬혜	actors	황우슬혜
황은정	actors	황은정
황정민	actors	황정민
황정민	actors	황정민
황정순	actors	황정순
황정음	actors	황정음
가비엔제이	singers	가비엔제이
가비퀸즈	singers	가비퀸즈
가희	singers	가희
간미연	singers	간미연
강민경	singers	강민경
강수지	singers	강수지
강연경	singers	강연경
거미	singers	거미
금잔디	singers	금잔디
김설(가수)	singers	김설
길건	singers	길건
길미	singers	길미
길은정	singers	길은정
길학미	singers	길학미
김그림	singers	김그림
김나영	singers	김나영
김동희	singers	김동희
김보경(1990)	singers	김보경
김상희	singers	김상희
김소리	singers	김소리
김소희	singers	김소희
김수희	singers	김수희
김승미	singers	김승미
김여희	singers	김여희
김연자	singers	김연자
김연지	singers	김연지
김예림	singers	김예림
김완선	singers	김완선
김용임	singers	김용임
김윤아	singers	김윤아
김윤희	singers	김윤희
김지연(1968)	singers	김지연
김추자	singers	김추자
김현정	singers	김현정
김혜림	singers	김혜림
김혜연	singers	김혜연
김희진(가수)	singers	김희진
김희진(트로트가수)	singers	김희진
나미	singers	나미
나비	singers	나비
나희경	singers	나희경
나르샤	singers	나르샤
남영주	singers	남영주
노사연	singers	노사연
노영심	singers	노영심
다나	singers	다나
다비치	singers	다비치
두리	singers	두리
디바	singers	디바
럼블 피쉬	singers	럼블 피쉬
레이나	singers	레이나
레이디 제인	singers	레이디 제인
로시	singers	로시
로티플스카이	singers	로티플스카이
루나	singers	루나
루시아	singers	루시아
류원정	singers	류원정
리사	singers	리사
리아	singers	리아
린	singers	린
마야	singers	마야
맑음	singers	맑음
메이다니	singers	메이다니
메이린	singers	메이린
메이비	singers	메이비
문주란	singers	문주란
문지은	singers	문지은
문희옥	singers	문희옥
미나	singers	미나
민서	singers	민서
민아	singers	민아
민티	singers	민티
민효린	singers	민효린
바다	singers	바다
박기영	singers	박기영
박길라	singers	박길라
박미경	singers	박미경
박서진	singers	박서진
박선주	singers	박선주
박성연(트로트가수)	singers	박성연
박정현	singers	박정현
박지윤	singers	박지윤
박향림	singers	박향림
박혜경	singers	박혜경
방실이	singers	방실이
배다해	singers	배다해
백난아	singers	백난아
백설희	singers	백설희
백아연	singers	백아연
백지영	singers	백지영
베이지	singers	베이지
벤	singers	벤
별	singers	별
사문영	singers	사문영
샤넌	singers	샤넌
서문탁	singers	서문탁
서연	singers	서연
서영은	singers	서영은
서인영	singers	서인영
서지영	singers	서지영
서진영	singers	서진영
서주경	singers	서주경
선미	singers	선미
선우정아	singers	선우정아
선하	singers	선하
성은	singers	성은
세정	singers	세정
스테파니	singers	스테파니
소냐	singers	소냐
소유	singers	소유
소이	singers	소이
소찬휘	singers	소찬휘
소향	singers	소향
손가인	singers	손가인
손담비	singers	손담비
손승연	singers	손승연
솔비	singers	솔비
솔지	singers	솔지
송가인	singers	송가인
송소희	singers	송소희
송지은	singers	송지은
수지	singers	수지
숙희	singers	숙희
수란	singers	수란
신은성	singers	신은성
신지	singers	신지
신효범	singers	신효범
심수봉	singers	심수봉
신고은	singers	신고은
아이비	singers	아이비
아이	singers	아이
아이유	singers	아이유
안녕하신가영	singers	안녕하신가영
안예슬	singers	안예슬
안지영	singers	안지영
알리	singers	알리
애즈 원	singers	애즈 원
양수경	singers	양수경
양파	singers	양파
양희은	singers	양희은
엄정화	singers	엄정화
에일리	singers	에일리
엘수정	singers	엘수정
연분홍	singers	연분홍
연우	singers	연우
연진	singers	연진
오승원	singers	오승원
오승은	singers	오승은
옥상달빛	singers	옥상달빛
옥주현	singers	옥주현
왁스	singers	왁스
요아리	singers	요아리
요조	singers	요조
웅산	singers	웅산
유니	singers	유니
유미	singers	유미
유지나	singers	유지나
윤미래	singers	윤미래
윤복희	singers	윤복희
윤수현	singers	윤수현
윤시내	singers	윤시내
윤하	singers	윤하
이가이	singers	이가이
이가희	singers	이가희
이금희	singers	이금희
이나	singers	이나
이난영	singers	이난영
이미자	singers	이미자
이보람	singers	이보람
이상은	singers	이상은
이선희	singers	이선희
이소라	singers	이소라
이소은	singers	이소은
이안(가수)	singers	이안
이수영	singers	이수영
이애란	singers	이애란
이영현	singers	이영현
이윤정	singers	이윤정
이융진	singers	이융진
이은미	singers	이은미
이은하	singers	이은하
이자연	singers	이자연
이정은(가수)	singers	이정은
이정현	singers	이정현
이지연	singers	이지연
이지혜	singers	이지혜
이진아	singers	이진아
이채언루트	singers	이채언루트
이하이	singers	이하이
이해리	singers	이해리
이혜리	singers	이혜리
이효리	singers	이효리
인순이	singers	인순이
임상아	singers	임상아
임정희	singers	임정희
임주리	singers	임주리
임지현	singers	임지현
임현정	singers	임현정
자두	singers	자두
장나라	singers	장나라
장미	singers	장미
장윤정	singers	장윤정
장재인	singers	장재인
장혜진	singers	장혜진
적우	singers	적우
전소미	singers	전소미
전소연	singers	전소연
전효성	singers	전효성
정다경	singers	정다경
정수라	singers	정수라
정은지	singers	정은지
정인	singers	정인
정훈희	singers	정훈희
정희라	singers	정희라
제시카	singers	제시카
제아	singers	제아
제이세라	singers	제이세라
조갑경	singers	조갑경
조미미	singers	조미미
조은새	singers	조은새
조유진	singers	조유진
죠앤	singers	죠앤
주니엘	singers	주니엘
주현미	singers	주현미
주희	singers	주희
지아	singers	지아
지원이	singers	지원이
지헤라	singers	지헤라
진미령	singers	진미령
진주	singers	진주
차윤지	singers	차윤지
차지연	singers	차지연
채연	singers	채연
청하	singers	청하
최연제	singers	최연제
최유나	singers	최유나
최진희	singers	최진희
크리샤 츄	singers	크리샤 츄
키스(한국 가수)	singers	키스
타루	singers	타루
태연	singers	태연
패티김	singers	패티김
하늘	singers	하늘
하리	singers	하리
하수빈	singers	하수빈
하진	singers	하진
하춘화	singers	하춘화
한나	singers	한나
한담희	singers	한담희
한명숙	singers	한명숙
한영애	singers	한영애
한혜진	singers	한혜진
허민(1981)	singers	허민
현미	singers	현미
현숙	singers	현숙
현아	singers	현아
헤이즈	singers	헤이즈
혜은이	singers	혜은이
화요비	singers	화요비
호란	singers	호란
홍진영	singers	홍진영
황보	singers	황보
황인선	singers	황인선
효린	singers	효린
효연	singers	효연
BMK	singers	BMK
BoA	singers	BoA
G.NA	singers	G.NA
HAIL	singers	HAIL
HEYNE	singers	HEYNE
JJ(가수)	singers	JJ
KATIE	singers	KATIE
Leeds	singers	Leeds
MIIII	singers	MIIII
NC.A	singers	NC.A
J.ae	singers	J.ae
Ori	singers	Ori
SURAN	singers	SURAN
강균성	singers	강균성
강산에	singers	강산에
강성훈	singers	강성훈
강승윤	singers	강승윤
강인봉	singers	강인봉
강진	singers	강진
강타	singers	강타
개리	singers	개리
견우	singers	견우
고유진	singers	고유진
구원찬	singers	구원찬
구윤회	singers	구윤회
구자명	singers	구자명
국카스텐	singers	국카스텐
권순일(가수)	singers	권순일
권인하	singers	권인하
김건모	singers	김건모
김규종	singers	김규종
김경록	singers	김경록
김경현	singers	김경현
김경호	singers	김경호
김광석	singers	김광석
김광진	singers	김광진
김국환	singers	김국환
김동률	singers	김동률
김동한(가수)	singers	김동한
김민기	singers	김민기
김민수	singers	김민수
김민우	singers	김민우
김민종	singers	김민종
김바다	singers	김바다
김범룡	singers	김범룡
김범수	singers	김범수
김상민	singers	김상민
김성면	singers	김성면
김세환	singers	김세환
김수찬	singers	김수찬
김수철	singers	김수철
김연우	singers	김연우
김용준	singers	김용준
김원준	singers	김원준
김원중	singers	김원중
김일두	singers	김일두
김장훈	singers	김장훈
김정민	singers	김정민
김정수	singers	김정수
김정호	singers	김정호
김조한	singers	김조한
김종국	singers	김종국
김종민	singers	김종민
김종서(가수)	singers	김종서
김종수(가수)	singers	김종수
김종환(가수)	singers	김종환
김준(1944)	singers	김준
김지수	singers	김지수
김지훈(가수)	singers	김지훈
김진표	singers	김진표
김진호	singers	김진호
김태우(1970)	singers	김태우
김태우(god)	singers	김태우
김태욱	singers	김태욱
김필	singers	김필
김헌영	singers	김헌영
김혁건	singers	김혁건
김현성	singers	김현성
김현식	singers	김현식
김현중	singers	김현중
김현철	singers	김현철
김형섭	singers	김형섭
김형준	singers	김형준
김형중	singers	김형중
김환성	singers	김환성
김흥국	singers	김흥국
김동명	singers	김동명
기리보이	singers	기리보이
나얼	singers	나얼
나윤권	singers	나윤권
나훈아	singers	나훈아
남인수	singers	남인수
남진	singers	남진
남훈	singers	남훈
넬	singers	넬
노라조	singers	노라조
노유민	singers	노유민
노을	singers	노을
노지훈	singers	노지훈
녹색지대	singers	녹색지대
달빛요정역전만루홈런	singers	달빛요정역전만루홈런
더보이즈	singers	더보이즈
더원	singers	더원
데프콘	singers	데프콘
듀크(가수)	singers	듀크
드렁큰 타이거	singers	드렁큰 타이거
로맨틱펀치	singers	로맨틱펀치
로이킴	singers	로이킴
루시드폴	singers	루시드폴
리치	singers	리치
마리오	singers	마리오
멜로망스	singers	멜로망스
모세	singers	모세
문명진	singers	문명진
문성훈	singers	문성훈
문희준	singers	문희준
민경훈	singers	민경훈
바비 킴	singers	바비 킴
바이브	singers	바이브
박강성	singers	박강성
박남정	singers	박남정
박상규	singers	박상규
박상민	singers	박상민
박상철	singers	박상철
박상태	singers	박상태
박서진	singers	박서진
박완규	singers	박완규
박용하	singers	박용하
박재범	singers	박재범
박재정	singers	박재정
박재홍	singers	박재홍
박정민	singers	박정민
박진영	singers	박진영
박현빈	singers	박현빈
박효신	singers	박효신
방성우	singers	방성우
방탄소년단	singers	방탄소년단
배일호	singers	배일호
배호	singers	배호
백년설	singers	백년설
백청강	singers	백청강
버스커 버스커	singers	버스커 버스커
버즈(한국 밴드)	singers	버즈
벅(한국 가수)	singers	벅
변진섭	singers	변진섭
브로	singers	브로
비	singers	비
빅뱅	singers	빅뱅
서동욱	singers	서동욱
서유석	singers	서유석
서인국	singers	서인국
서재호	singers	서재호
서지원	singers	서지원
서태지	singers	서태지
설운도	singers	설운도
성시경	singers	성시경
성태	singers	성태
손진영	singers	손진영
손헌수	singers	손헌수
송대관	singers	송대관
송창식	singers	송창식
신상훈	singers	신상훈
신성우	singers	신성우
신승훈	singers	신승훈
신용재	singers	신용재
신유	singers	신유
신철	singers	신철
신해철	singers	신해철
심신	singers	심신
심현보	singers	심현보
싸이	singers	싸이
어쿠루브	singers	어쿠루브
안재욱	singers	안재욱
안치환	singers	안치환
알트	singers	알트
양동근	singers	양동근
양준일	singers	양준일
양지원	singers	양지원
양진석	singers	양진석
에디 킴	singers	에디 킴
에릭남	singers	에릭남
에픽하이	singers	에픽하이
오브로젝트	singers	오브로젝트
오승근	singers	오승근
올라이즈 밴드	singers	올라이즈 밴드
유선호	singers	유선호
유승우	singers	유승우
유열	singers	유열
유영석	singers	유영석
유영진	singers	유영진
유재하	singers	유재하
유정석	singers	유정석
유희열	singers	유희열
윤건	singers	윤건
윤도현	singers	윤도현
윤민수	singers	윤민수
윤상	singers	윤상
윤종신	singers	윤종신
윤형주	singers	윤형주
이광필	singers	이광필
이규호(음악인)	singers	이규호
이기찬	singers	이기찬
이남이	singers	이남이
이루	singers	이루
이무송	singers	이무송
이문세	singers	이문세
이박사	singers	이박사
이상우	singers	이상우
이석	singers	이석
이석훈	singers	이석훈
이성우	singers	이성우
이성진	singers	이성진
이수	singers	이수
이수만	singers	이수만
이승기	singers	이승기
이승철	singers	이승철
이승환	singers	이승환
이용	singers	이용
이장우	singers	이장우
이장희	singers	이장희
이적	singers	이적
이정	singers	이정
이정선	singers	이정선
이정현	singers	이정현
이준오	singers	이준오
이지수	singers	이지수
이진성	singers	이진성
이현	singers	이현
이현우	singers	이현우
이효선	singers	이효선
일락	singers	일락
임병수	singers	임병수
임영웅	singers	임영웅
임형주	singers	임형주
임재범	singers	임재범
임창정	singers	임창정
임태경	singers	임태경
임한별	singers	임한별
장기하	singers	장기하
장문복	singers	장문복
장범준	singers	장범준
장수원	singers	장수원
장혁	singers	장혁
장현	singers	장현
장효진	singers	장효진
전영록	singers	전영록
전인권	singers	전인권
전진	singers	전진
정광태	singers	정광태
정기고	singers	정기고
정두언	singers	정두언
정동하	singers	정동하
정승환	singers	정승환
정엽	singers	정엽
정준영	singers	정준영
정준일	singers	정준일
정철	singers	정철
정태춘	singers	정태춘
조관우	singers	조관우
조규만	singers	조규만
조규찬	singers	조규찬
조덕배	singers	조덕배
조성모	singers	조성모
조영남	singers	조영남
조용필	singers	조용필
조장혁	singers	조장혁
조정치	singers	조정치
조정현	singers	조정현
조진원	singers	조진원
조태준	singers	조태준
조하문	singers	조하문
조항조	singers	조항조
조현민	singers	조현민
존박	singers	존박
지석진	singers	지석진
진성	singers	진성
진시몬	singers	진시몬
진해성	singers	진해성
천명훈	singers	천명훈
채동하	singers	채동하
최광수(가수)	singers	최광수
최락	singers	최락
최백호	singers	최백호
최선원	singers	최선원
최성수	singers	최성수
최성원(가수)	singers	최성원
최용준	singers	최용준
최재훈(가수)	singers	최재훈
최정원(1981년 5월)	singers	최정원
최진영	singers	최진영
최헌	singers	최헌
최희준	singers	최희준
카이	singers	카이
케빈 박	singers	케빈 박
탁재훈	singers	탁재훈
태진아	singers	태진아
패닉(가수)	singers	패닉
편승엽	singers	편승엽
포스트맨(가수)	singers	포스트맨
하동균	singers	하동균
하림	singers	하림
하하	singers	하하
하현우	singers	하현우
한대수	singers	한대수
한복남	singers	한복남
한승희	singers	한승희
허공	singers	허공
허각	singers	허각
허민(1929)	singers	허민
허영생	singers	허영생
혁오	singers	혁오
현승민	singers	현승민
현인	singers	현인
현진영	singers	현진영
현철	singers	현철
홍경민	singers	홍경민
홍대광	singers	홍대광
홍서범	singers	홍서범
홍성민	singers	홍성민
환희(업텐션)	singers	환희
환희(플라이 투 더 스카이)	singers	환희
황규영	singers	황규영
황선영	singers	황선영
황치열	singers	황치열
휘성	singers	휘성
홍종구	singers	홍종구
BUMZU	singers	BUMZU
DAY6	singers	DAY6
H	singers	H
Hitchhiker	singers	Hitchhiker
JK김동욱	singers	JK김동욱
KCM	singers	KCM
K.WILL	singers	K.WILL
MC몽	singers	MC몽
NELL	singers	NELL
SE7EN	singers	SE7EN
V.One	singers	V.One
Zion.T	singers	Zion.T
YB	singers	YB
강용석	entertainers	강용석
강호동	entertainers	강호동
기안84	entertainers	기안84
김장훈	entertainers	김장훈
김제동	entertainers	김제동
김종국	entertainers	김종국
김종민	entertainers	김종민
희철	entertainers	희철
강민혁(가수)	entertainers	강민혁
강석(코미디언)	entertainers	강석
강석우	entertainers	강석우
강혁민	entertainers	강혁민
개리(래퍼)	entertainers	개리
고수(배우)	entertainers	고수
그렉 프리스터	entertainers	그렉 프리스터
그리(래퍼)	entertainers	그리
김경식	entertainers	김경식
김광규(배우)	entertainers	김광규
김광일(언론인)	entertainers	김광일
김광한	entertainers	김광한
김구라	entertainers	김구라
김국진	entertainers	김국진
김동건(방송인)	entertainers	김동건
김민재(배우)	entertainers	김민재
김병만	entertainers	김병만
김성주(방송인)	entertainers	김성주
김승현(방송인)	entertainers	김승현
김용만	entertainers	김용만
김창열(가수)	entertainers	김창열
김태진(방송인)	entertainers	김태진
김학도	entertainers	김학도
김한국	entertainers	김한국
노홍철	entertainers	노홍철
남창희	entertainers	남창희
노유민	entertainers	노유민
대도서관(방송인)	entertainers	대도서관
도티	entertainers	도티
데프콘(가수)	entertainers	데프콘
도경완	entertainers	도경완
맹기용	entertainers	맹기용
박명수	entertainers	박명수
백종원	entertainers	백종원
비(연예인)	entertainers	비
박재민	entertainers	박재민
박종진	entertainers	박종진
박지호(1988)	entertainers	박지호
박지훈(변호사)	entertainers	박지훈
배철수	entertainers	배철수
백일섭	entertainers	백일섭
붐(연예인)	entertainers	붐
서장훈	entertainers	서장훈
신동엽(코미디언)	entertainers	신동엽
서세원	entertainers	서세원
선바	entertainers	선바
선바/도네이션	entertainers	선바/도네이션
설민석	entertainers	설민석
손범수	entertainers	손범수
송재익	entertainers	송재익
송지헌	entertainers	송지헌
송해	entertainers	송해
신구(배우)	entertainers	신구
신상옥	entertainers	신상옥
신승준	entertainers	신승준
신정환	entertainers	신정환
안정환	entertainers	안정환
유선호	entertainers	유선호
유재석	entertainers	유재석
윤종신	entertainers	윤종신
은지원	entertainers	은지원
이동국	entertainers	이동국
이승기	entertainers	이승기
이준석(정치인)	entertainers	이준석
이천수	entertainers	이천수
아하부장	entertainers	아하부장
안윤상	entertainers	안윤상
알케이	entertainers	알케이
양재웅	entertainers	양재웅
양치승	entertainers	양치승
오성식(강사)	entertainers	오성식
오현민	entertainers	오현민
왕종근	entertainers	왕종근
우노벅스	entertainers	우노벅스
유병재	entertainers	유병재
유수호(1972)	entertainers	유수호
유승우(가수)	entertainers	유승우
유승호	entertainers	유승호
유퉁	entertainers	유퉁
유해진	entertainers	유해진
이계진	entertainers	이계진
이기우(배우)	entertainers	이기우
이동근(아나운서)	entertainers	이동근
이동우(코미디언)	entertainers	이동우
이동휘(배우)	entertainers	이동휘
이문세	entertainers	이문세
이상용	entertainers	이상용
이성진(NRG)	entertainers	이성진
이세용	entertainers	이세용
이수근	entertainers	이수근
이종환(방송인)	entertainers	이종환
이진성(1976)	entertainers	이진성
이호근	entertainers	이호근
이홍렬	entertainers	이홍렬
이휘재	entertainers	이휘재
임권택	entertainers	임권택
임백천	entertainers	임백천
임용수	entertainers	임용수
임지훈(가수)	entertainers	임지훈
임택근	entertainers	임택근
정준하	entertainers	정준하
자니 윤	entertainers	자니 윤
장성규	entertainers	장성규
장수원	entertainers	장수원
전현무	entertainers	전현무
정기고	entertainers	정기고
정재용	entertainers	정재용
제이쓴	entertainers	제이쓴
조영구	entertainers	조영구
주영훈	entertainers	주영훈
지석진	entertainers	지석진
지조	entertainers	지조
차인태	entertainers	차인태
천명훈	entertainers	천명훈
철희(가수)	entertainers	철희
최두영	entertainers	최두영
최욱	entertainers	최욱
최희준(기자)	entertainers	최희준
파토코치	entertainers	파토코치
편승엽	entertainers	편승엽
표인봉	entertainers	표인봉
2005075	entertainers	2005075
하일(방송인)	entertainers	하일
홍진호	entertainers	홍진호
한문철	entertainers	한문철
한석규	entertainers	한석규
한석준	entertainers	한석준
한재석(1991)	entertainers	한재석
허지웅	entertainers	허지웅
허참	entertainers	허참
현주엽	entertainers	현주엽
홍록기	entertainers	홍록기
홍서범	entertainers	홍서범
홍석천	entertainers	홍석천
홍혜걸	entertainers	홍혜걸
황인용	entertainers	황인용
황철순	entertainers	황철순
황태순	entertainers	황태순
K.WILL	entertainers	K.WILL
LJ	entertainers	LJ
찰스	entertainers	찰스
JR(뉴이스트)	entertainers	JR
MC 노민	entertainers	MC 노민
강승화	entertainers	강승화
강용식	entertainers	강용식
김기덕(DJ)	entertainers	김기덕
김민규(2001)	entertainers	김민규
김민수(아나운서)	entertainers	김민수
김요한(1999)	entertainers	김요한
김익근	entertainers	김익근
김진(방송인)	entertainers	김진
김충재	entertainers	김충재
김환성	entertainers	김환성
박대우	entertainers	박대우
박시진	entertainers	박시진
박종윤(축구해설가)	entertainers	박종윤
백운기	entertainers	백운기
변웅전	entertainers	변웅전
오스틴 강	entertainers	오스틴 강
유정현(방송인)	entertainers	유정현
이근철	entertainers	이근철
이상벽	entertainers	이상벽
이승륜	entertainers	이승륜
이영돈(1956)	entertainers	이영돈
임성훈(방송인)	entertainers	임성훈
전영호	entertainers	전영호
정영진	entertainers	정영진
정지원(스포츠 캐스터)	entertainers	정지원
주철환	entertainers	주철환
최영일(1966)	entertainers	최영일
하재익	entertainers	하재익
한명재	entertainers	한명재
황수관	entertainers	황수관
황인성(아나운서)	entertainers	황인성
강소연	entertainers	강소연
강수정	entertainers	강수정
강예원	entertainers	강예원
고현정	entertainers	고현정
곽현화	entertainers	곽현화
구지성	entertainers	구지성
권주현(아나운서)	entertainers	권주현
금비(거북이)	entertainers	금비
김경란	entertainers	김경란
김경화(방송인)	entertainers	김경화
김라라	entertainers	김라라
김민아	entertainers	김민아
김소영(방송인)	entertainers	김소영
김소희(모델)	entertainers	김소희
김유리(1980)	entertainers	김유리
김주희(방송인)	entertainers	김주희
김지나	entertainers	김지나
김지민(배우)	entertainers	김지민
김진경	entertainers	김진경
김진아(치어리더)	entertainers	김진아
노영희(법조인)	entertainers	노영희
노현정	entertainers	노현정
문지애	entertainers	문지애
바다(가수)	entertainers	바다
박경림	entertainers	박경림
박나림	entertainers	박나림
박미선	entertainers	박미선
박슬기	entertainers	박슬기
박지윤(MC)	entertainers	박지윤
박초현	entertainers	박초현
박하얀	entertainers	박하얀
박혜진(방송인)	entertainers	박혜진
백지연	entertainers	백지연
변서은	entertainers	변서은
서유리	entertainers	서유리
송가인	entertainers	송가인
송은이	entertainers	송은이
사오리 장	entertainers	사오리 장
서동주	entertainers	서동주
서정희	entertainers	서정희
서현진(방송인)	entertainers	서현진
성유리	entertainers	성유리
손미나	entertainers	손미나
송지효	entertainers	송지효
신세휘	entertainers	신세휘
신아라	entertainers	신아라
신은하	entertainers	신은하
이효리	entertainers	이효리
안문숙	entertainers	안문숙
안현모	entertainers	안현모
양수빈	entertainers	양수빈
오세아(가수)	entertainers	오세아
오영주	entertainers	오영주
오인영	entertainers	오인영
오정연	entertainers	오정연
옥주현	entertainers	옥주현
왕영은	entertainers	왕영은
유보화	entertainers	유보화
유승옥	entertainers	유승옥
유진(1981)	entertainers	유진
유호정	entertainers	유호정
윤영미	entertainers	윤영미
윤지연	entertainers	윤지연
이경실	entertainers	이경실
이성미	entertainers	이성미
이영자	entertainers	이영자
이지애	entertainers	이지애
이지연(1975)	entertainers	이지연
이진	entertainers	이진
전소미	entertainers	전소미
조혜련	entertainers	조혜련
장윤정(배우)	entertainers	장윤정
장윤주	entertainers	장윤주
재키 림	entertainers	재키 림
전성초	entertainers	전성초
전소민	entertainers	전소민
정선혜(방송인)	entertainers	정선혜
정이수	entertainers	정이수
정인영(방송인)	entertainers	정인영
정주리	entertainers	정주리
제니(BLACKPINK)	entertainers	제니
조수빈	entertainers	조수빈
조은나래	entertainers	조은나래
조은정(방송인)	entertainers	조은정
지원이	entertainers	지원이
지정남	entertainers	지정남
최유라	entertainers	최유라
최윤영(방송인)	entertainers	최윤영
최현정(방송인)	entertainers	최현정
최희	entertainers	최희
팽현숙	entertainers	팽현숙
혜리	entertainers	혜리
하리수	entertainers	하리수
한혜진(모델)	entertainers	한혜진
현영	entertainers	현영
홍영기(1992)	entertainers	홍영기
홍진경	entertainers	홍진경
화사(마마무)	entertainers	화사
황보(가수)	entertainers	황보
황보미(방송인)	entertainers	황보미
황수경(방송인)	entertainers	황수경
황수정	entertainers	황수정
후지타 사유리	entertainers	후지타 사유리
강예빈	entertainers	강예빈
공서영	entertainers	공서영
구새봄	entertainers	구새봄
김나영(1981)	entertainers	김나영
김민서(경매사)	entertainers	김민서
김민아(아나운서)	entertainers	김민아
김바니	entertainers	김바니
김새롬	entertainers	김새롬
김소희(요리사)	entertainers	김소희
김시향	entertainers	김시향
김원희	entertainers	김원희
김유연	entertainers	김유연
김유정(정치인)	entertainers	김유정
김정진	entertainers	김정진
김지윤(방송인)	entertainers	김지윤
김해나	entertainers	김해나
김해현	entertainers	김해현
김혜영(코미디언)	entertainers	김혜영
나승연	entertainers	나승연
노윤주	entertainers	노윤주
락채은	entertainers	락채은
레나(MC)	entertainers	레나
레이 양	entertainers	레이 양
리아(연예인)	entertainers	리아
박성은	entertainers	박성은
박소현(배우)	entertainers	박소현
박신영(방송인)	entertainers	박신영
박은지	entertainers	박은지
박지영(아나운서)	entertainers	박지영
박찬숙(방송인)	entertainers	박찬숙
배지현	entertainers	배지현
백보람	entertainers	백보람
선하	entertainers	선하
신아영	entertainers	신아영
신예지	entertainers	신예지
아비가일 알데레떼	entertainers	아비가일 알데레떼
안선영	entertainers	안선영
안혜경	entertainers	안혜경
양한나	entertainers	양한나
연상은	entertainers	연상은
예정화	entertainers	예정화
오정해	entertainers	오정해
원자현	entertainers	원자현
윤소영	entertainers	윤소영
윤재인	entertainers	윤재인
윤태진	entertainers	윤태진
이금희(방송인)	entertainers	이금희
이다도시	entertainers	이다도시
이상아	entertainers	이상아
이수정(1987)	entertainers	이수정
이순실	entertainers	이순실
이승현(아나운서)	entertainers	이승현
이신애	entertainers	이신애
이연화(1991)	entertainers	이연화
이영옥	entertainers	이영옥
이예빈	entertainers	이예빈
이재은(아나운서)	entertainers	이재은
이종은	entertainers	이종은
이주원(아나운서)	entertainers	이주원
이지연(1947)	entertainers	이지연
이지영	entertainers	이지영
이지은(1999)	entertainers	이지은
이채은	entertainers	이채은
이파니	entertainers	이파니
임윤선(법조인)	entertainers	임윤선
장예인	entertainers	장예인
정지원(아나운서)	entertainers	정지원
조윤경	entertainers	조윤경
조현정(아나운서)	entertainers	조현정
최한빛	entertainers	최한빛
크리스티나 콘팔로니에리	entertainers	크리스티나 콘팔로니에리
하지영	entertainers	하지영
한민용	entertainers	한민용
한성주	entertainers	한성주
한영(방송인)	entertainers	한영
한주희	entertainers	한주희
FX걸	models	FX걸
PPL(걸그룹)	models	PPL
강경민(1994)	models	강경민
강선혜	models	강선혜
강승현(모델)	models	강승현
강초원(모델)	models	강초원
강하빈	models	강하빈
고말숙	models	고말숙
고소현(모델)	models	고소현
고주아	models	고주아
곽지영	models	곽지영
구지성	models	구지성
김나나(레이싱 모델)	models	김나나
김나정	models	김나정
김다울	models	김다울
김다인(배우)	models	김다인
김동수(패션모델)	models	김동수
김라라	models	김라라
김라영	models	김라영
김류아	models	김류아
김민경(에이전트)	models	김민경
김새롬	models	김새롬
김세라	models	김세라
김소희(모델)	models	김소희
김스테파니헤리	models	김스테파니헤리
김시향	models	김시향
김시후(레이싱 모델)	models	김시후
김영아(모델)	models	김영아
김용지	models	김용지
김우현(모델)	models	김우현
김원경	models	김원경
김유민	models	김유민
김유연	models	김유연
김유이	models	김유이
김지나	models	김지나
김진경	models	김진경
김진아(치어리더)	models	김진아
김진이	models	김진이
김효진(레이싱 모델)	models	김효진
김희정(1991)	models	김희정
도여름	models	도여름
류미오	models	류미오
류지혜	models	류지혜
문가경	models	문가경
문가비	models	문가비
문세림	models	문세림
문현주	models	문현주
민시아	models	민시아
바나나(모델)	models	바나나
박서진	models	박서진
박선아	models	박선아
박세진(배우)	models	박세진
박소유(레이싱 모델)	models	박소유
박시현(레이싱 모델)	models	박시현
박영선(모델)	models	박영선
박지은(레이싱 모델)	models	박지은
박청아	models	박청아
박초현	models	박초현
박하얀	models	박하얀
박한솔(배우)	models	박한솔
박현영	models	박현영
박희정	models	박희정
방은영	models	방은영
배다빈	models	배다빈
배윤영	models	배윤영
백지원	models	백지원
변정민	models	변정민
변정하	models	변정하
보고싶진아	models	보고싶진아
서리나	models	서리나
서사랑	models	서사랑
서설희	models	서설희
서정희	models	서정희
서진아	models	서진아
성혜민	models	성혜민
소주연	models	소주연
솜해인	models	솜해인
송경아	models	송경아
송수진	models	송수진
송주아	models	송주아
송해나	models	송해나
수주	models	수주
스테파니 리	models	스테파니 리
신도현	models	신도현
신민희	models	신민희
신재은(모델)	models	신재은
신현지	models	신현지
심소영	models	심소영
아름송이	models	아름송이
아이린 킴	models	아이린 킴
아지(모델)	models	아지
안미선	models	안미선
안예원	models	안예원
안유정	models	안유정
엄상미	models	엄상미
엄지언	models	엄지언
여연희	models	여연희
연지은	models	연지은
연초아	models	연초아
오아희	models	오아희
오윤아	models	오윤아
우주안	models	우주안
유리사	models	유리사
유진(레이싱 모델)	models	유진
유혜영(아나운서)	models	유혜영
윤승아	models	윤승아
윤주하	models	윤주하
윤채원	models	윤채원
윤한비	models	윤한비
윤희성(레이싱 모델)	models	윤희성
은하영(레이싱 모델)	models	은하영
이다연(레이싱 모델)	models	이다연
이다희(레이싱 모델)	models	이다희
이린(1998)	models	이린
이보림	models	이보림
이봄이	models	이봄이
이선진	models	이선진
이성경	models	이성경
이성화(레이싱 모델)	models	이성화
이소라(모델)	models	이소라
이소정(모델)	models	이소정
이솜	models	이솜
이수정(1987)	models	이수정
이슬아(배우)	models	이슬아
이시현(모델)	models	이시현
이아린(레이싱 모델)	models	이아린
이아윤	models	이아윤
이연(피트니스 모델)	models	이연
이연아	models	이연아
이연윤(레이싱 모델)	models	이연윤
이영(레이싱 모델)	models	이영
이영진(배우)	models	이영진
이예린(모델)	models	이예린
이예빈	models	이예빈
이은혜(레이싱 모델)	models	이은혜
이지나	models	이지나
이지연(배우)	models	이지연
이진이	models	이진이
이채은	models	이채은
이채은(레이싱 모델)	models	이채은
이현이	models	이현이
이현정	models	이현정
이현지(모델)	models	이현지
이혜상	models	이혜상
이호정	models	이호정
이효영	models	이효영
임보라	models	임보라
임블리	models	임블리
임솔아	models	임솔아
임지우	models	임지우
장윤주	models	장윤주
장은홍(모델)	models	장은홍
장희령	models	장희령
전보람(모델)	models	전보람
정두리	models	정두리
정소현	models	정소현
정아라	models	정아라
정유나(모델)	models	정유나
정유승	models	정유승
정유진(배우)	models	정유진
정주희(레이싱 모델)	models	정주희
정호연(모델)	models	정호연
조세희(레이싱 모델)	models	조세희
조혜주	models	조혜주
주다하	models	주다하
주지아	models	주지아
주현정	models	주현정
지이수	models	지이수
지현정(모델)	models	지현정
진아름	models	진아름
진정선	models	진정선
진희경	models	진희경
최소라	models	최소라
표은지	models	표은지
하선우	models	하선우
한담희	models	한담희
한미모(레이싱 모델)	models	한미모
한성민	models	한성민
한송이(1988)	models	한송이
한수희	models	한수희
한유리	models	한유리
한으뜸	models	한으뜸
한혜진(모델)	models	한혜진
햄재희	models	햄재희
허윤미	models	허윤미
혜박	models	혜박
홍진경	models	홍진경
황기쁨	models	황기쁨
황현주(모델)	models	황현주
강은탁	models	강은탁
강철웅	models	강철웅
강철웅/미디어	models	강철웅/미디어
구자성	models	구자성
권도균	models	권도균
권태은	models	권태은
기도훈	models	기도훈
김민승(배우)	models	김민승
김승환(모델)	models	김승환
김영광(배우)	models	김영광
김영대(배우)	models	김영대
김영승	models	김영승
김우빈	models	김우빈
김원중(모델)	models	김원중
김재영(배우)	models	김재영
김재욱(배우)	models	김재욱
김종훈	models	김종훈
김진곤(모델)	models	김진곤
김칠두	models	김칠두
남윤수	models	남윤수
노진욱	models	노진욱
도상우	models	도상우
류지광	models	류지광
마르코(배우)	models	마르코
문수인	models	문수인
박성진(모델)	models	박성진
박지운(모델)	models	박지운
박태민(모델)	models	박태민
박희우	models	박희우
배정남	models	배정남
백경도	models	백경도
백종원(배우)	models	백종원
서도영	models	서도영
성민서	models	성민서
성준(배우)	models	성준
소지섭	models	소지섭
송재림	models	송재림
신승호	models	신승호
신재혁	models	신재혁
신정유	models	신정유
신지훈(배우)	models	신지훈
심지호(배우)	models	심지호
이광수(배우)	models	이광수
Bboy Sway	models	Bboy Sway
장기용	models	장기용
장미관	models	장미관
장태훈	models	장태훈
전지훈	models	전지훈
정우성	models	정우성
정혁(모델)	models	정혁
주어진	models	주어진
주우재	models	주우재
주지훈	models	주지훈
줄리엔 강	models	줄리엔 강
지현성	models	지현성
차승원	models	차승원
천승호	models	천승호
최성용(1994)	models	최성용
한현민(모델)	models	한현민
홍종현	models	홍종현
황인엽	models	황인엽
강호동	comedians	강호동
김준호(코미디언)	comedians	김준호
나도야	comedians	나도야
남궁경호	comedians	남궁경호
남보원	comedians	남보원
남상호(코미디언)	comedians	남상호
남성남	comedians	남성남
남영환	comedians	남영환
남진우	comedians	남진우
남철	comedians	남철
남태령(개그맨)	comedians	남태령
남호연	comedians	남호연
남희석	comedians	남희석
내시십분	comedians	내시십분
노우진	comedians	노우진
노정렬	comedians	노정렬
려명하	comedians	려명하
류근일(코미디언)	comedians	류근일
류근지	comedians	류근지
류담	comedians	류담
류정남	comedians	류정남
리마리오	comedians	리마리오
문세윤	comedians	문세윤
문원종	comedians	문원종
문천식	comedians	문천식
문풍지	comedians	문풍지
미키광수	comedians	미키광수
민성준(개그맨)	comedians	민성준
박명수	comedians	박명수
신동엽(코미디언)	comedians	신동엽
심형래	comedians	심형래
유재석	comedians	유재석
이경규	comedians	이경규
장동민	comedians	장동민
정준하	comedians	정준하
차민준	comedians	차민준
채경선	comedians	채경선
최국	comedians	최국
최군	comedians	최군
최기섭	comedians	최기섭
최병서	comedians	최병서
최부기	comedians	최부기
최성민(코미디언)	comedians	최성민
최승태(코미디언)	comedians	최승태
최양락	comedians	최양락
최영수(코미디언)	comedians	최영수
최영준(코미디언)	comedians	최영준
최우선	comedians	최우선
최재욱(코미디언)	comedians	최재욱
최재원(코미디언)	comedians	최재원
최효종	comedians	최효종
추대엽	comedians	추대엽
컬투	comedians	컬투
표인봉	comedians	표인봉
피식대학	comedians	피식대학
하박	comedians	하박
하준수(개그맨)	comedians	하준수
한무	comedians	한무
한민관	comedians	한민관
한상규	comedians	한상규
한승훈	comedians	한승훈
한으뜸(개그맨)	comedians	한으뜸
한정호	comedians	한정호
한현민(코미디언)	comedians	한현민
허경환	comedians	허경환
허동환	comedians	허동환
허태희	comedians	허태희
현병수	comedians	현병수
호찬	comedians	호찬
홍가람	comedians	홍가람
홍경준	comedians	홍경준
홍기훈	comedians	홍기훈
홍동명	comedians	홍동명
홍록기	comedians	홍록기
홍성기	comedians	홍성기
홍성현	comedians	홍성현
홍순목(코미디언)	comedians	홍순목
홍인규	comedians	홍인규
홍종호	comedians	홍종호
홍현호	comedians	홍현호
홍훤	comedians	홍훤
화니지니	comedians	화니지니
황기순	comedians	황기순
황봉알	comedians	황봉알
황영진	comedians	황영진
황제성	comedians	황제성
황현희	comedians	황현희
DJ 찰스	comedians	DJ 찰스
MC 딩동	comedians	MC 딩동
강유미	comedians	강유미
강주희	comedians	강주희
고은영(개그우먼)	comedians	고은영
곽현화	comedians	곽현화
구혜리	comedians	구혜리
권미진	comedians	권미진
권진영(1979)	comedians	권진영
권혜수	comedians	권혜수
김경아(코미디언)	comedians	김경아
김나희(개그우먼)	comedians	김나희
김다온	comedians	김다온
김마주	comedians	김마주
김명선(코미디언)	comedians	김명선
김미려	comedians	김미려
김미연(코미디언)	comedians	김미연
김미진(코미디언)	comedians	김미진
김미화	comedians	김미화
김민경(개그우먼)	comedians	김민경
김민정	comedians	김민정
김민정(코미디언)	comedians	김민정
김보화	comedians	김보화
김성은	comedians	김성은
김수미(코미디언)	comedians	김수미
김숙	comedians	김숙
김승혜	comedians	김승혜
김신영	comedians	김신영
김영하(코미디언)	comedians	김영하
김영희(개그우먼)	comedians	김영희
김유연	comedians	김유연
김정현(개그우먼)	comedians	김정현
김주연	comedians	김주연
김지민(코미디언)	comedians	김지민
김지선(개그우먼)	comedians	김지선
김지혜(코미디언)	comedians	김지혜
김진아(코미디언)	comedians	김진아
김진주(개그우먼)	comedians	김진주
김현정(개그우먼)	comedians	김현정
김형은	comedians	김형은
김혜선(코미디언)	comedians	김혜선
김혜영(코미디언)	comedians	김혜영
김효진(코미디언)	comedians	김효진
김희원(코미디언)	comedians	김희원
류경진	comedians	류경진
맹승지	comedians	맹승지
박나래	comedians	박나래
박미선	comedians	박미선
박보드레	comedians	박보드레
박보미(개그우먼)	comedians	박보미
박소라(코미디언)	comedians	박소라
박소영(개그우먼)	comedians	박소영
박은영(개그우먼)	comedians	박은영
박지선	comedians	박지선
박지현(개그우먼)	comedians	박지현
박진아	comedians	박진아
박진주입니다	comedians	박진주입니다
박초은	comedians	박초은
박희진	comedians	박희진
방미	comedians	방미
배연정	comedians	배연정
변서은	comedians	변서은
송은이	comedians	송은이
안가연	comedians	안가연
안선영	comedians	안선영
안소미	comedians	안소미
안영미	comedians	안영미
양귀비(동음이의어)	comedians	양귀비
양희성	comedians	양희성
오나미	comedians	오나미
유쏘	comedians	유쏘
윤경화	comedians	윤경화
윤미숙	comedians	윤미숙
윤선희	comedians	윤선희
이경분	comedians	이경분
이경실	comedians	이경실
이경애	comedians	이경애
이경애(1981)	comedians	이경애
이국주	comedians	이국주
이성미	comedians	이성미
이세영(코미디언)	comedians	이세영
이수빈(개그우먼)	comedians	이수빈
이수지	comedians	이수지
이영자	comedians	이영자
이예림(1990년)	comedians	이예림
이은지(코미디언)	comedians	이은지
이은형	comedians	이은형
이정필	comedians	이정필
이진주(사업가)	comedians	이진주
이칠선	comedians	이칠선
이현정(코미디언)	comedians	이현정
이혜지	comedians	이혜지
이희경(개그우먼)	comedians	이희경
임라라	comedians	임라라
조혜련	comedians	조혜련
최서인	comedians	최서인
최은희(코미디언)	comedians	최은희
최정화	comedians	최정화
최희선(코미디언)	comedians	최희선
팽현숙	comedians	팽현숙
한지형	comedians	한지형
허미영	comedians	허미영
허민(코미디언)	comedians	허민
허안나	comedians	허안나
홍나영	comedians	홍나영
홍예슬	comedians	홍예슬
홍윤화	comedians	홍윤화
홍진경	comedians	홍진경
홍현희	comedians	홍현희
황신영	comedians	황신영
황정혜	comedians	황정혜
